47 47 47 47 47 47 47 47 47 47 47 47 47 47 47 47 47 47 47 47 47 47 47 47 47 47 47 47 47 47 47 47 47 47 47 47 47 47 47 47 47 47 47 47 47 47 47 47 47 47 
47 47 47 47 47 47 47 47 47 47 47 47 47 47 47 47 47 47 47 47 47 47 47 47 47 47 47 47 47 47 47 47 47 47 47 47 47 47 47 47 47 47 47 47 47 47 47 47 47 47 
47 47 47 47 47 47 47 47 47 47 47 47 47 47 47 47 47 47 47 47 47 47 47 47 47 47 47 47 47 47 47 47 47 47 47 47 47 47 47 47 47 47 47 47 47 47 47 47 47 47 
47 47 47 47 47 47 47 47 47 47 47 47 47 47 47 47 47 47 47 47 47 47 47 47 47 47 47 47 47 47 47 47 47 47 47 47 47 47 47 47 47 47 47 47 47 47 47 47 47 47 
47 47 47 47 47 47 47 47 47 47 47 47 47 47 47 47 47 47 47 47 47 47 47 47 47 47 47 47 47 47 47 47 47 47 47 47 47 47 47 47 47 47 47 47 47 47 47 47 47 47 
47 47 47 47 47 47 47 47 47 47 47 47 47 47 47 47 47 47 47 47 47 47 47 47 47 47 47 47 47 47 47 47 47 47 47 47 47 47 47 47 47 47 47 47 47 47 47 47 47 47 
47 47 47 47 47 47 47 3 3 3 3 3 3 3 3 3 3 3 3 3 3 3 3 3 3 3 3 3 3 3 3 3 3 3 3 3 3 3 3 3 3 3 3 47 47 47 47 47 47 47 
47 47 47 47 47 47 47 3 3 3 3 3 3 3 3 3 3 3 3 3 3 3 3 3 3 3 3 3 3 3 3 3 3 3 3 3 3 3 3 3 3 3 3 47 47 47 47 47 47 47 
47 47 47 47 47 47 47 3 3 3 3 3 3 3 3 3 3 3 3 3 3 3 3 3 46 46 46 3 3 3 3 3 3 3 3 3 3 3 3 3 3 3 3 47 47 47 47 47 47 47 
47 47 47 47 47 47 47 3 3 3 3 3 3 3 3 3 3 3 3 3 3 3 3 3 46 46 46 3 3 3 3 3 3 3 3 3 3 3 3 3 3 3 3 47 47 47 47 47 47 47 
47 47 47 47 47 47 47 3 3 3 3 3 3 3 3 3 3 3 3 3 3 3 3 3 3 46 3 3 3 3 3 3 3 3 3 3 3 3 3 3 3 3 3 47 47 47 47 47 47 47 
47 47 47 47 47 47 47 3 3 3 3 3 3 3 3 3 3 3 3 3 3 3 3 3 3 46 3 3 3 3 3 3 3 3 3 3 3 3 3 3 3 3 3 47 47 47 47 47 47 47 
47 47 47 47 47 47 47 3 3 3 3 3 3 3 3 3 3 3 3 3 3 3 3 3 3 46 3 3 3 3 3 3 3 3 3 3 3 3 3 3 3 3 3 47 47 47 47 47 47 47 
47 47 47 47 47 47 47 3 3 3 3 3 3 3 3 3 3 3 3 3 3 3 3 3 3 46 3 3 3 3 3 3 3 3 3 3 3 3 3 3 3 3 3 47 47 47 47 47 47 47 
47 47 47 47 47 47 47 3 3 3 3 3 3 3 3 3 3 3 3 3 3 3 3 3 3 46 3 3 3 3 3 3 3 3 3 3 3 3 3 3 3 3 3 47 47 47 47 47 47 47 
47 47 47 47 47 47 47 3 3 3 3 3 3 3 3 3 3 3 3 3 3 3 3 3 3 46 3 3 3 3 3 3 3 3 3 3 3 3 3 3 3 3 3 47 47 47 47 47 47 47 
47 47 47 47 47 47 47 3 3 3 3 3 3 3 3 3 3 3 3 3 46 46 46 46 46 46 46 46 46 46 3 3 3 3 3 3 3 3 3 3 3 3 3 47 47 47 47 47 47 47 
47 47 47 47 47 47 47 3 3 3 3 3 3 3 3 3 3 3 46 46 46 46 46 46 46 46 46 46 46 46 46 46 3 3 3 3 3 3 3 3 3 3 3 47 47 47 47 47 47 47 
47 47 47 47 47 47 47 3 3 3 3 3 3 3 3 3 3 46 46 46 46 46 46 46 46 46 46 46 46 46 46 46 46 46 3 3 3 3 3 3 3 3 3 47 47 47 47 47 47 47 
47 47 47 47 47 47 47 3 3 3 3 3 3 3 3 3 46 46 46 46 46 46 46 46 46 46 46 46 46 46 46 46 46 46 46 3 3 3 3 3 3 3 3 47 47 47 47 47 47 47 
47 47 47 47 47 47 47 3 3 3 3 3 3 3 3 46 46 46 46 46 46 46 46 46 46 46 46 46 46 46 46 46 46 46 46 3 3 3 3 3 3 3 3 47 47 47 47 47 47 47 
47 47 47 47 47 47 47 3 3 3 3 3 3 3 46 46 46 46 46 46 46 46 46 46 46 46 46 46 46 46 46 46 46 46 46 46 3 3 3 3 3 3 3 47 47 47 47 47 47 47 
47 47 47 47 47 47 47 3 3 3 3 3 3 3 46 46 46 46 46 46 46 46 46 46 46 46 46 46 46 46 46 46 46 46 46 46 3 3 3 3 3 3 3 47 47 47 47 47 47 47 
47 47 47 47 47 47 47 3 3 3 3 3 3 3 3 46 46 46 46 46 46 46 46 46 46 46 46 46 46 46 46 46 46 46 46 46 3 3 3 3 3 3 3 47 47 47 47 47 47 47 
47 47 47 47 47 47 47 3 3 3 3 3 3 3 3 46 46 46 46 46 46 46 46 46 46 46 46 46 46 46 46 46 46 46 46 46 3 3 3 3 3 3 3 47 47 47 47 47 47 47 
47 47 47 47 47 47 47 3 3 3 3 3 3 3 3 3 46 46 46 46 46 46 46 46 46 46 46 46 46 46 46 46 46 46 3 3 3 3 3 3 3 3 3 47 47 47 47 47 47 47 
47 47 47 47 47 47 47 3 3 3 3 3 3 3 3 3 3 3 46 46 46 46 46 46 46 46 46 46 46 46 46 46 46 3 3 3 3 3 3 3 3 3 3 47 47 47 47 47 47 47 
47 47 47 47 47 47 47 3 3 3 3 3 3 3 3 3 3 3 3 3 46 46 46 46 46 46 46 46 46 46 46 46 3 3 3 3 3 3 3 3 3 3 3 47 47 47 47 47 47 47 
47 47 47 47 47 47 47 3 3 3 3 3 3 3 3 3 3 3 3 3 3 3 3 3 3 46 3 3 3 3 3 3 3 3 3 3 3 3 3 3 3 3 3 47 47 47 47 47 47 47 
47 47 47 47 47 47 47 3 3 3 3 3 3 3 3 3 3 3 3 3 3 3 3 3 3 46 3 3 3 3 3 3 3 3 3 3 3 3 3 3 3 3 3 47 47 47 47 47 47 47 
47 47 47 47 47 47 47 3 3 3 3 3 3 3 3 3 3 3 3 3 3 3 3 3 3 46 3 3 3 3 3 3 3 3 3 3 3 3 3 3 3 3 3 47 47 47 47 47 47 47 
47 47 47 47 47 47 47 3 3 3 3 3 3 3 3 3 3 3 3 3 3 3 3 3 3 46 3 3 3 3 3 3 3 3 3 3 3 3 3 3 3 3 3 47 47 47 47 47 47 47 
47 47 47 47 47 47 47 3 3 3 3 3 3 3 3 3 3 3 3 3 3 3 3 3 3 46 3 3 3 3 3 3 3 3 3 3 3 3 3 3 3 3 3 47 47 47 47 47 47 47 
47 47 47 47 47 47 47 3 3 3 3 3 3 3 3 3 3 3 3 3 3 3 3 3 3 46 3 3 3 3 3 3 3 3 3 3 3 3 3 3 3 3 3 47 47 47 47 47 47 47 
47 47 47 47 47 47 47 3 3 3 3 3 3 3 3 3 3 3 3 3 3 3 3 3 3 46 3 3 3 3 3 3 3 3 3 3 3 3 3 3 3 3 3 47 47 47 47 47 47 47 
47 47 47 47 47 47 47 3 3 3 3 3 3 3 3 3 3 3 3 3 3 3 3 3 3 46 3 3 3 3 3 3 3 3 3 3 3 3 3 3 3 3 3 47 47 47 47 47 47 47 
47 47 47 47 47 47 47 3 3 3 3 3 3 3 3 3 3 3 3 3 3 3 3 3 3 46 46 3 3 3 3 3 3 3 3 3 3 3 3 3 3 3 3 47 47 47 47 47 47 47 
47 47 47 47 47 47 47 3 3 3 3 3 3 3 3 3 3 3 3 3 3 3 3 3 3 3 46 3 3 3 3 3 3 3 3 3 3 3 3 3 3 3 3 47 47 47 47 47 47 47 
47 47 47 47 47 47 47 3 3 3 3 3 3 3 3 3 3 3 3 3 3 3 3 3 3 3 46 3 3 3 3 3 3 3 3 3 3 3 3 3 3 3 3 47 47 47 47 47 47 47 
47 47 47 47 47 47 47 3 3 3 3 3 3 3 3 3 3 3 3 3 3 3 3 3 3 46 46 46 3 3 3 3 3 3 3 3 3 3 3 3 3 3 3 47 47 47 47 47 47 47 
47 47 47 47 47 47 47 3 3 3 3 3 3 3 3 3 3 3 3 3 3 3 3 3 3 46 46 46 3 3 3 3 3 3 3 3 3 3 3 3 3 3 3 47 47 47 47 47 47 47 
47 47 47 47 47 47 47 3 3 3 3 3 3 3 3 3 3 3 3 3 3 3 3 3 3 46 44 46 3 3 3 3 3 3 3 3 3 3 3 3 3 3 3 47 47 47 47 47 47 47 
47 47 47 47 47 47 47 3 3 3 3 3 3 3 3 3 3 3 3 3 3 3 3 3 3 3 3 3 3 3 3 3 3 3 3 3 3 3 3 3 3 3 3 47 47 47 47 47 47 47 
47 47 47 47 47 47 47 3 3 3 3 3 3 3 3 3 3 3 3 3 3 3 3 3 3 3 3 3 3 3 3 3 3 3 3 3 3 3 3 3 3 3 3 47 47 47 47 47 47 47 
47 47 47 47 47 47 47 47 47 47 47 47 47 47 47 47 47 47 47 47 47 47 47 47 47 47 47 47 47 47 47 47 47 47 47 47 47 47 47 47 47 47 47 47 47 47 47 47 47 47 
47 47 47 47 47 47 47 47 47 47 47 47 47 47 47 47 47 47 47 47 47 47 47 47 47 47 47 47 47 47 47 47 47 47 47 47 47 47 47 47 47 47 47 47 47 47 47 47 47 47 
47 47 47 47 47 47 47 47 47 47 47 47 47 47 47 47 47 47 47 47 47 47 47 47 47 47 47 47 47 47 47 47 47 47 47 47 47 47 47 47 47 47 47 47 47 47 47 47 47 47 
47 47 47 47 47 47 47 47 47 47 47 47 47 47 47 47 47 47 47 47 47 47 47 47 47 47 47 47 47 47 47 47 47 47 47 47 47 47 47 47 47 47 47 47 47 47 47 47 47 47 
47 47 47 47 47 47 47 47 47 47 47 47 47 47 47 47 47 47 47 47 47 47 47 47 47 47 47 47 47 47 47 47 47 47 47 47 47 47 47 47 47 47 47 47 47 47 47 47 47 47 
47 47 47 47 47 47 47 47 47 47 47 47 47 47 47 47 47 47 47 47 47 47 47 47 47 47 47 47 47 47 47 47 47 47 47 47 47 47 47 47 47 47 47 47 47 47 47 47 47 47 
