3 3 3 3 3 3 3 3 3 3 3 3 3 3 3 3 3 3 3 3 3 3 3 3 3 3 3 3 3 3 3 3 3 3 3 3 3 3 3 3 3 3 3 3 3 3 3 3 3 3 
3 35 35 35 36 40 40 40 40 40 40 26 25 25 25 35 23 41 40 40 40 37 37 37 40 40 40 40 24 40 40 40 40 40 22 40 40 40 40 40 37 40 37 40 40 37 40 40 40 3
3 35 35 35 41 40 22 40 40 40 40 26 25 25 25 35 23 41 40 41 40 40 40 40 40 40 40 41 40 37 37 37 37 40 40 40 40 40 41 40 40 40 40 40 37 40 40 37 40 3 
3 35 35 35 36 40 40 40 40 40 40 26 25 25 25 35 23 40 40 37 37 37 37 41 37 37 37 37 40 37 40 40 40 37 37 37 37 41 41 37 37 37 41 40 40 40 37 40 40 3 
3 35 35 35 36 40 40 40 40 40 40 26 25 25 25 35 23 40 41 40 41 40 40 40 40 40 40 37 40 40 40 40 40 40 37 40 40 40 37 40 37 41 40 37 37 37 40 40 37 3
3 35 35 35 41 40 40 40 40 40 40 26 25 25 25 35 23 40 37 40 37 40 37 40 37 40 40 37 37 40 37 40 40 40 40 37 40 40 40 40 40 40 40 37 37 37 37 40 37 3
3 35 35 35 36 40 40 40 40 40 40 26 25 25 25 35 23 40 40 40 40 40 40 40 40 41 40 40 40 37 40 40 40 40 40 40 40 40 37 40 37 40 40 37 40 40 40 40 40 3 
3 35 35 35 36 40 40 40 40 40 40 26 25 25 25 35 23 37 37 37 37 37 40 40 24 41 41 40 40 40 37 40 40 40 40 40 37 40 40 37 40 40 40 40 40 40 40 37 40 3
3 35 35 35 41 40 40 40 22 40 40 26 25 25 25 35 23 37 37 37 37 40 40 40 40 40 41 41 41 40 40 41 40 24 40 40 37 37 40 40 40 37 40 40 40 40 40 40 40 3
3 35 35 35 41 40 40 40 40 40 40 26 25 25 25 35 23 37 37 37 40 40 40 40 40 40 40 41 41 41 40 40 37 41 37 40 40 40 40 40 40 40 37 40 40 40 40 41 40 3
3 35 35 35 36 40 40 40 40 40 40 26 25 25 25 35 23 37 40 40 40 40 40 40 40 40 38 41 36 41 40 40 37 41 37 40 40 39 40 40 40 40 22 40 40 40 37 40 40 3
3 35 35 35 36 40 40 40 40 40 40 27 29 29 29 28 40 40 40 40 40 40 40 40 40 40 40 37 41 40 40 40 40 40 37 37 41 37 37 41 40 40 40 37 40 37 40 40 40 3
3 35 35 35 41 23 23 23 40 23 23 40 40 40 40 40 40 40 40 40 40 40 40 40 40 40 40 37 37 41 40 40 40 40 40 40 40 40 40 40 41 40 40 40 40 40 40 37 40 3
3 35 35 35 41 40 23 23 40 23 23 40 40 40 40 40 40 40 40 40 36 36 36 36 36 36 36 36 36 36 36 36 36 36 41 40 40 40 24 40 40 37 40 40 37 40 37 40 40 3
3 35 35 35 41 40 23 23 40 23 23 40 40 40 40 40 40 23 23 23 22 23 23 23 23 23 23 37 37 27 23 23 23 23 40 40 40 40 41 40 40 40 37 40 40 40 40 37 40 3
3 35 35 35 36 40 23 23 40 23 23 40 40 40 40 40 40 23 23 23 23 23 23 23 23 23 23 37 37 37 23 23 23 23 40 40 41 37 40 40 40 41 35 35 35 40 40 40 40 3
3 35 35 35 36 40 23 23 40 23 23 40 40 40 40 40 40 23 23 23 23 23 23 23 23 23 23 37 37 37 23 23 23 23 40 40 40 40 37 40 40 41 35 35 35 40 40 40 37 3            
3 35 35 35 36 40 23 23 40 23 23 40 40 40 40 40 40 23 23 23 23 23 23 23 23 23 23 37 37 37 23 23 23 23 40 41 40 41 40 40 41 37 35 35 35 40 24 22 40 3
3 35 35 35 36 40 23 23 40 23 23 40 40 40 40 40 40 37 23 23 23 23 23 23 23 23 23 37 37 37 23 23 23 23 40 40 40 38 40 37 40 40 35 35 35 40 40 40 40 3
3 35 35 35 36 40 23 23 40 23 23 40 40 38 40 40 40 37 23 23 23 23 23 23 23 23 23 37 37 37 23 23 23 23 40 23 40 40 40 40 40 40 40 41 40 40 38 40 40 3
3 35 35 35 36 40 23 23 40 23 23 40 40 40 40 40 40 40 23 23 23 23 37 37 37 37 37 37 37 37 23 23 23 23 41 40 40 37 40 40 40 36 25 25 41 40 40 40 40 3
3 35 35 35 36 40 23 23 40 23 23 40 40 40 40 40 40 40 23 23 23 23 37 40 40 37 37 37 37 37 23 23 23 23 23 40 40 37 40 40 40 25 25 25 37 40 37 37 40 3
3 40 40 40 40 40 40 40 40 40 40 40 40 40 40 40 40 23 23 23 23 23 37 40 40 40 40 40 40 40 37 23 23 41 23 40 40 40 40 40 40 40 40 41 40 40 38 40 40 3
3 43 40 40 40 40 40 40 37 40 40 40 40 40 40 40 40 23 23 23 23 23 37 40 40 40 40 40 40 40 37 23 23 23 40 40 40 40 40 21 40 40 40 40 41 40 40 40 40 3
3 43 40 40 40 40 22 40 40 40 40 40 40 37 37 37 40 23 23 23 23 23 37 40 40 37 37 37 40 40 37 37 37 37 37 23 40 40 40 23 23 23 23 37 37 40 40 23 23 3 
3 40 40 40 40 40 40 40 21 40 40 40 37 37 37 37 40 23 23 23 37 37 37 37 37 37 37 37 40 40 40 40 40 40 40 40 40 40 40 40 37 37 40 40 40 40 40 41 41 3
3 40 40 40 40 40 40 40 40 40 40 40 40 37 37 37 40 40 23 23 37 37 25 25 25 25 25 37 40 40 40 40 40 40 24 40 40 37 37 40 37 40 40 37 37 40 41 35 41 3
3 40 40 40 40 40 40 40 37 40 40 40 40 40 37 37 40 40 23 23 37 25 25 25 25 25 25 37 37 40 40 40 40 40 40 40 37 37 37 40 40 40 40 37 40 40 40 35 35 3
3 35 35 35 36 40 40 40 23 40 40 40 40 40 40 37 40 40 23 23 37 25 25 25 25 25 25 25 37 37 37 37 37 37 40 22 37 37 37 40 40 40 37 40 40 37 40 40 40 3 
3 35 35 35 41 40 22 22 23 40 40 40 40 23 40 40 40 23 23 23 37 25 25 25 25 25 25 25 37 37 37 37 37 37 40 40 37 40 37 40 40 37 40 40 40 40 40 41 40 3
3 35 35 35 41 40 22 22 23 40 40 40 40 23 40 40 40 23 23 23 37 25 25 25 25 25 25 25 25 25 25 25 25 37 40 40 40 40 40 40 37 40 40 40 37 40 40 41 40 3
3 35 35 35 36 40 22 22 23 40 40 37 40 41 40 40 40 23 23 23 37 25 25 25 25 25 25 25 25 25 25 25 25 37 40 38 40 40 40 37 40 40 40 37 40 40 40 40 37 3
3 35 35 35 41 40 22 22 23 40 40 37 40 23 40 40 40 23 23 23 37 37 37 25 25 25 25 25 25 25 25 25 25 37 40 40 40 40 37 40 40 40 40 40 40 40 37 40 40 3
3 35 35 35 36 40 22 40 23 40 40 40 40 23 40 40 40 23 23 23 23 23 37 25 25 25 25 25 25 25 25 25 25 37 39 40 40 37 40 40 40 40 40 40 40 40 37 40 41 3
3 35 35 35 41 40 40 40 23 40 40 40 40 23 40 40 40 23 23 23 23 23 37 25 25 25 25 25 25 25 25 25 25 37 40 40 37 40 40 40 40 40 40 40 40 37 40 40 40 3
3 35 35 35 36 40 40 40 23 40 40 40 40 40 40 40 40 23 23 23 23 23 37 25 25 25 25 25 25 25 25 25 25 37 40 37 40 40 37 40 40 40 40 40 37 40 40 37 40 3
3 35 35 35 41 40 40 40 23 40 40 40 40 40 40 40 40 23 23 23 23 23 37 37 37 37 37 37 37 37 37 37 37 37 40 40 37 40 40 40 40 40 40 37 40 40 40 40 40 3
3 35 35 35 41 40 40 40 23 40 40 40 40 40 40 40 40 40 37 37 41 41 41 40 40 40 40 40 40 40 40 40 37 40 40 40 40 37 40 40 40 40 37 40 40 40 40 40 40 3
3 35 35 35 41 40 40 40 40 40 40 27 29 29 29 32 23 40 41 37 40 40 37 40 37 40 40 22 40 40 40 40 40 40 37 40 40 40 37 40 40 37 40 40 40 21 37 37 40 3
3 35 35 35 41 40 40 40 40 40 40 26 25 25 25 35 23 40 40 40 40 40 40 40 38 37 40 40 40 37 40 40 40 37 37 40 40 40 40 40 37 37 40 40 40 40 40 40 40 3
3 35 35 35 36 40 40 40 40 40 40 26 25 25 25 35 23 40 40 40 40 24 40 40 40 40 40 37 37 40 40 37 40 40 40 40 40 40 40 37 37 40 40 40 40 39 21 40 37 3 
3 35 35 35 36 40 40 40 40 40 40 26 25 25 25 35 23 40 37 38 37 40 40 39 40 21 40 37 40 40 22 40 37 40 37 40 40 40 37 37 40 40 37 40 38 40 40 40 40 3
3 35 35 35 36 40 40 40 40 40 40 26 25 25 25 35 23 40 39 37 40 40 22 40 40 38 40 37 40 40 40 40 37 40 40 40 40 41 40 37 37 40 40 40 40 40 40 37 40 3
3 35 35 35 41 40 40 40 40 40 40 26 25 25 25 35 23 40 37 40 40 40 40 37 40 40 40 40 40 40 40 40 40 40 37 37 37 40 40 40 40 40 37 40 40 40 37 40 40 3
3 35 35 35 41 40 40 40 40 40 40 26 25 25 25 35 23 40 37 40 37 40 37 40 40 40 40 40 40 40 40 37 40 40 40 37 40 40 40 41 40 40 40 40 40 37 37 40 40 3
3 35 35 35 41 40 40 40 40 40 40 26 25 25 25 35 23 40 40 37 40 40 40 40 40 21 40 37 40 37 37 37 40 40 41 40 40 37 40 37 41 40 37 37 40 40 40 24 40 3
3 35 35 35 36 40 40 40 40 40 40 26 25 25 25 35 23 40 37 40 37 40 37 37 37 40 40 40 37 37 40 40 40 37 40 40 37 40 40 40 40 40 37 37 40 40 22 40 40 3
3 35 35 35 36 40 40 40 40 40 40 26 25 25 25 35 23 40 37 22 40 37 40 40 40 41 38 40 37 40 37 24 40 37 40 41 40 40 22 24 40 37 40 40 40 37 40 40 40 3
3 35 35 35 41 40 40 40 40 40 40 26 25 25 25 35 23 40 40 40 40 40 40 37 40 40 40 40 40 40 40 40 40 40 40 40 37 40 40 40 40 40 40 40 37 40 40 40 37 3
3 3 3 3 3 3 3 3 3 3 3 3 3 3 3 3 3 3 3 3 3 3 3 3 3 3 3 3 3 3 3 3 3 3 3 3 3 3 3 3 3 3 3 3 3 3 3 3 3 3  
